####################
#O                O#
#         S        #
#                  #
# M             X  #
#                  #
#    M             #
#                  #
#O                O#
####################