####################
#O            M   O#
#   M           M  #
#   M         MMMMM#
#B            X    #
#                  #
#    C       S   M #
#               M  #
#O          W   M O#
#################### 