####################
#O                O#
#    MMMMM    M    #
#                  #
#B            X    #
#     MMMMMMMMMMMMM#
#    C             #
# MMMMM    S       #
#O                O#
#################### 