####################
#O                O#
#         S        #
#                  #
#                  #
#                  #
#    M             #
#                  #
#O                O#
####################