####################
#O    M           O#
#    M    S     M  #
#                  #
#B      M MM  X    #
#                  #
#    C       MMM  M#
#                  #
#O                O#
#################### 