####################
#O                O#
#             M    #
#                  #
#B            X    #
#                  #
#    C             #
#          S       #
#O                O#
####################