####################
#O                O#
#    M MMM    M    #
#                  #
#B            X    #
#     MM MMMMMMMMM #
#    C             #
# MM M    S        #
#O                O#
#################### 