####################
#O    M           O#
#    M         M   #
#                  #
#B      MMMM  X    #
#                  #
#    C       MMM  M#
#                  #
#O   S            O#
#################### 