####################
#O            M   O#
#   M    S      M  #
#   M         MMMMM#
#B            X    #
#                  #
#    C          M  #
#               M  #
#O              M O#
#################### 