####################
#O    B           O#
#              M   #
#                  #
#                  #
#                  #
#                  #
#          S       #
#O                O#
####################           
